4 4 4 4 4 4 4 4 4 4 4 4 4 4 4 4 4 4 4 4 4 4 4 4 4 4 4 4 4 4 4 4 4 4 4 4 4 4 4 4 4 4 4 4 4 4 4 4 4 4 4 4 4 4 4 0 4 4 4 4
4 6 6 6 6 6 6 6 6 6 6 0 0 3 6 6 6 6 6 6 6 6 6 6 6 6 6 6 6 0 0 0 0 0 0 0 0 3 6 0 0 0 0 0 0 0 0 0 3 6 0 0 0 0 0 0 0 0 0 4
4 6 1 1 1 1 1 1 1 1 6 0 0 3 6 1 1 1 1 1 1 1 1 1 1 1 1 1 6 0 0 0 0 0 0 0 0 3 6 0 0 0 0 0 0 0 0 0 0 0 0 0 0 0 0 0 0 0 0 4
4 6 7 7 7 7 7 7 7 7 6 0 0 3 6 7 7 7 7 7 7 7 7 7 7 7 7 7 6 0 0 0 0 0 0 0 0 3 6 0 0 0 0 0 0 0 0 0 3 6 0 0 0 0 0 0 0 0 0 4
4 6 7 7 7 7 7 7 7 7 6 0 0 3 6 7 7 7 7 7 7 7 7 7 7 7 7 7 6 0 0 0 0 0 0 0 0 3 6 0 0 0 0 0 0 0 0 0 3 6 0 0 0 0 0 0 0 0 0 4
4 6 7 7 7 7 7 7 7 7 6 0 0 3 6 7 7 7 7 7 7 7 7 7 7 7 7 7 6 0 0 3 6 6 8 6 6 6 6 6 6 6 0 0 3 6 6 6 6 6 6 6 6 6 6 6 6 6 6 4
4 6 7 7 7 7 7 7 7 7 6 0 0 3 6 7 7 7 7 7 7 7 7 7 7 7 7 7 6 0 0 3 6 1 2 1 1 1 1 1 1 6 0 0 3 6 1 1 1 1 1 1 1 1 1 1 1 1 6 4
4 6 7 7 7 7 7 7 7 7 6 0 0 3 6 6 8 8 6 6 6 6 6 6 6 6 8 6 6 0 0 3 6 7 7 7 7 7 7 7 7 6 0 0 3 6 7 7 7 7 7 7 7 7 7 7 7 7 6 4
4 6 7 7 7 7 7 7 7 7 6 0 0 3 1 1 2 2 1 1 1 1 1 1 6 1 9 1 1 0 0 3 6 7 7 7 7 7 7 7 7 6 0 0 3 6 7 7 7 7 7 7 7 7 7 7 7 7 6 4
4 6 6 6 6 8 8 6 6 6 6 0 0 0 5 5 5 5 5 5 5 5 5 3 6 5 5 5 5 0 0 3 6 7 7 7 7 7 7 7 7 6 0 0 3 6 7 7 7 7 7 7 7 7 7 7 7 7 6 4
4 1 1 1 1 2 2 1 1 1 1 0 0 0 0 0 0 0 0 0 0 0 0 3 6 0 0 0 0 0 0 3 6 7 7 7 7 7 7 7 7 6 0 0 3 6 7 7 7 7 7 7 7 7 7 7 7 7 6 4
4 5 5 5 5 5 5 5 5 5 5 0 0 0 0 0 0 0 0 0 0 0 0 3 6 0 0 0 0 0 0 3 6 7 7 7 7 7 7 7 7 6 0 0 3 6 7 7 7 7 7 7 7 7 7 7 7 7 6 4
4 0 0 0 0 0 0 0 0 0 0 0 0 0 0 0 0 0 0 0 0 0 0 3 6 0 0 0 0 0 0 3 6 7 7 7 7 7 7 7 7 6 0 0 3 6 6 6 6 7 7 7 7 7 7 7 7 7 6 4
4 6 6 6 6 6 6 6 6 6 6 6 8 6 6 6 6 6 6 6 6 6 6 6 6 6 0 0 0 0 0 3 6 7 7 7 7 7 7 7 7 6 0 0 3 1 1 1 6 7 7 7 7 7 7 7 7 7 6 4
4 6 1 1 1 1 1 1 1 1 6 1 9 1 6 1 1 1 1 1 1 1 1 1 1 6 0 0 0 0 0 3 6 7 7 7 7 7 7 7 7 6 0 0 0 5 5 5 6 6 6 6 6 6 8 6 6 6 6 4
4 6 7 7 7 7 7 7 7 7 6 5 5 5 6 7 7 7 7 7 7 7 7 7 7 6 0 0 0 0 0 3 6 7 7 7 7 7 7 7 7 6 0 0 0 0 0 3 6 1 1 1 1 1 9 1 1 1 6 4
4 6 7 7 7 7 7 7 7 7 6 0 0 0 6 7 7 7 7 7 7 7 7 7 7 6 0 0 0 0 0 3 6 6 6 6 8 8 6 6 6 6 0 0 0 0 0 3 6 7 7 7 7 7 7 7 7 7 6 4
4 6 7 7 7 7 7 7 7 7 6 0 0 0 6 7 7 7 7 7 7 7 7 7 7 6 0 0 0 0 0 3 6 1 1 1 2 2 1 1 1 6 0 0 3 6 6 8 6 7 7 7 7 7 7 7 7 7 6 4
4 6 7 7 7 7 7 7 7 7 6 6 8 6 6 7 7 7 7 7 7 7 7 7 7 6 0 0 0 0 0 3 6 7 7 7 7 7 7 7 7 6 0 0 3 6 1 2 1 7 7 7 7 7 7 7 7 7 6 4
4 6 7 7 7 7 7 7 7 7 6 1 2 1 6 7 7 7 7 7 7 7 7 7 7 6 0 0 0 0 0 3 6 7 7 7 7 7 7 7 7 6 0 0 3 6 7 7 7 7 7 7 7 7 7 7 7 7 6 4
4 6 7 7 7 7 7 7 7 7 6 5 5 3 6 7 7 7 7 7 7 7 7 7 7 6 0 0 0 0 0 3 6 7 7 7 7 7 7 7 7 6 0 0 3 6 7 7 7 7 7 7 7 7 7 7 7 7 6 4
4 6 7 7 7 7 7 7 7 7 6 0 0 3 6 7 7 7 7 7 7 7 7 7 7 6 0 0 0 0 0 3 6 7 7 7 7 7 7 7 7 6 0 0 3 6 7 7 7 7 7 7 7 7 7 7 7 7 6 4
4 6 6 6 6 8 8 6 6 6 6 0 0 3 6 6 6 6 6 8 8 6 6 6 6 6 0 0 0 0 0 3 6 7 7 7 7 7 7 7 7 6 0 0 3 6 6 6 6 6 6 8 8 6 6 6 6 6 6 4
4 1 1 1 1 2 2 1 1 1 1 0 0 3 1 1 1 1 1 2 2 1 1 1 1 6 0 0 0 0 0 3 6 7 7 7 7 7 7 7 7 6 0 0 3 1 1 1 1 1 1 2 2 1 1 1 1 1 1 4
4 5 5 5 5 5 5 5 5 5 5 0 0 0 5 5 5 5 5 5 5 5 5 5 3 6 0 0 0 0 0 3 6 7 7 7 7 7 7 7 7 6 0 0 0 5 5 5 5 5 5 5 5 5 5 5 5 5 5 4
4 0 0 0 0 0 0 0 0 0 0 0 0 0 0 0 0 0 0 0 0 0 0 0 3 6 0 0 0 0 0 3 6 7 7 7 7 7 7 7 7 6 0 0 0 0 0 0 0 0 0 0 0 0 0 0 0 0 0 4
4 6 6 6 6 8 8 6 6 6 6 0 0 3 6 6 6 6 6 8 8 6 6 6 6 6 0 0 0 0 0 3 6 7 7 7 7 7 7 7 7 6 0 0 0 0 0 0 0 0 0 0 0 0 0 0 0 0 0 4
4 6 1 1 1 2 2 1 1 1 6 0 0 3 6 1 1 1 1 2 2 1 1 1 1 6 0 0 0 0 0 3 6 6 6 6 8 6 6 6 6 6 6 6 6 6 6 6 6 6 6 0 0 0 0 0 0 0 0 4
4 6 7 7 7 7 7 7 7 7 6 0 0 3 6 7 7 7 7 7 7 7 7 7 7 6 0 0 0 0 0 3 6 1 1 1 9 1 1 1 1 1 1 1 1 1 1 1 1 1 6 0 0 0 0 0 0 0 0 4
4 6 7 7 7 7 7 7 7 7 6 0 0 3 6 7 7 7 7 7 7 7 7 7 7 6 0 0 0 0 0 3 6 7 7 7 7 7 7 7 7 7 7 7 7 7 7 7 7 7 6 0 0 0 0 0 0 0 0 4
4 6 7 7 7 7 7 7 7 7 6 0 0 3 6 7 7 7 7 7 7 7 7 7 7 6 0 0 0 0 0 3 6 7 7 7 7 7 7 7 7 7 7 7 7 7 7 7 7 7 6 0 0 0 0 0 0 0 0 4
4 6 7 7 7 7 7 7 7 7 6 0 0 3 6 7 7 7 7 7 7 7 7 7 7 6 0 0 0 0 0 3 6 7 7 7 7 7 7 7 7 7 7 7 7 7 7 7 7 7 6 0 0 0 0 0 0 0 0 4
4 6 7 7 7 7 7 7 7 7 6 0 0 3 6 7 7 7 7 7 7 7 7 7 7 6 0 0 0 0 0 3 6 7 7 7 7 7 7 7 7 7 7 7 7 7 7 7 7 7 6 0 0 0 0 0 0 0 0 4
4 6 7 7 7 7 7 7 7 7 6 0 0 3 6 7 7 7 7 7 7 7 7 7 7 6 0 0 0 0 0 3 6 7 7 7 7 7 7 7 7 7 7 7 7 7 7 7 7 7 6 0 0 0 0 0 0 0 0 4
4 6 7 7 7 7 7 7 7 7 6 0 0 3 6 7 7 7 7 7 7 7 7 7 7 6 6 6 6 6 6 6 6 6 6 6 6 6 6 6 8 8 6 6 6 6 6 6 6 6 6 0 0 0 0 0 0 0 0 4
4 6 7 7 7 7 7 7 7 7 6 0 0 3 6 7 7 7 7 7 7 7 7 7 7 6 1 1 1 1 1 1 1 1 1 1 1 1 1 1 2 2 1 1 1 1 1 1 1 1 1 0 0 0 0 0 0 0 0 4
4 6 7 7 7 7 7 7 7 7 6 0 0 3 6 7 7 7 7 7 7 7 7 7 7 6 5 5 5 5 5 5 5 5 5 5 5 5 5 5 5 5 5 5 5 5 5 5 5 5 5 0 0 0 0 0 0 0 0 4
4 6 6 6 6 6 6 6 6 6 6 0 0 3 6 6 6 6 6 6 6 6 6 6 6 6 0 0 0 0 0 0 0 0 0 0 0 0 0 0 0 0 0 0 0 0 0 0 0 0 0 0 0 0 0 0 0 0 0 4
4 1 1 1 1 1 1 1 1 1 1 0 0 3 1 1 1 1 1 1 1 1 1 1 1 1 0 0 0 0 0 0 0 0 0 0 0 0 0 0 0 0 0 0 0 0 0 0 0 0 0 0 0 0 0 0 0 0 0 4
4 4 4 4 4 4 4 4 4 4 4 4 4 4 4 4 4 4 4 4 4 4 4 4 4 4 4 4 4 4 4 4 4 4 4 4 4 4 4 4 4 4 4 4 4 4 4 4 4 4 4 4 4 4 4 4 4 4 4 4
